5 8 9394 9343 9280 9065 9142 9087 8946 8841 
5 5 9343 9279 9086 8965 8805 
5 5 9394 9370 9383 9243 9085 
5 6 9394 9466 9477 9426 9416 9395 
5 5 9085 9054 8886 8792 8804 
5 4 8841 8762 8690 8645 
5 7 9280 9293 9477 9549 9370 9279 9280 
4 7 8645 8585 8518 8519 8652 8781 8854 
4 13 8854 8794 8842 8822 8876 8896 8813 8753 8782 8830 8713 8626 8691 
3 7 8692 8755 8715 8627 8593 8550 8579 
2 15 8579 8551 8497 8454 8414 8475 8415 8498 8476 8182 8036 7897 7849 7656 7505 
2 11 7505 7310 7061 6880 6747 6968 6951 6866 6556 6308 5917 
1 6 7505 7604 7623 7635 7624 7438 
5 13 9085 9001 8910 8805 8737 8679 8701 8821 8841 8976 9104 9237 9395 
1 18 8691 8667 8603 8637 8638 8653 8571 8578 8654 8604 8588 8589 8590 8531 8591 8605 8655 8692 
5 2 9394 9549 
4 6 9549 9548 9652 9766 9916 10067 
1 4 9477 9615 9796 9944 
1 5 9395 9528 9684 9810 9944 
4 11 9395 9427 9573 9550 9707 9823 9802 9863 9842 9833 9811 
3 5 9944 9906 9971 10102 10067 
3 8 10067 9905 9775 9651 9526 9357 9208 9085 
3 6 9811 9723 9602 9468 9358 9212 
3 4 9212 9079 8956 8854 
1 12 9811 9797 9695 9531 9405 9281 9186 9088 9067 9056 8991 8830 
2 7 9823 9832 9831 9841 9887 9951 9944 
1 11 9395 9253 9230 9184 9210 9287 9344 9211 9128 9165 9212 
4 7 8841 8725 8569 8361 8247 8123 8084 
3 5 8645 8504 8340 8199 8084 
3 6 8519 8350 8236 8174 8069 8084 
3 6 7331 7206 7072 6941 6834 6655 
4 6 8084 7943 7826 7695 7567 7331 
5 5 8805 8689 8548 8428 8320 
4 5 8804 8634 8465 8398 8320 
4 9 8320 8257 8152 8173 8097 8026 7875 7835 7836 
2 5 8084 7981 7966 7942 7836 
3 6 7836 7694 7558 7559 7412 7331 
4 6 8804 8700 8537 8436 8267 8225 
4 12 8320 8151 8053 7954 7893 7751 7683 7574 7409 7287 7116 6976 
3 7 8320 8233 8133 8178 8226 8161 8225 
2 6 8178 8052 7980 7892 7782 7683 
1 9 8579 8693 8756 8832 9057 9170 9480 9591 9608 
1 9 9608 9804 9879 9954 10015 10213 10334 10481 10630 
1 8 7438 7570 7657 7689 7673 7715 7907 8158 
1 6 8158 8441 8833 9408 9409 9373 
4 6 6976 6870 6801 6738 6676 6570 
3 8 6976 7053 7054 7109 7117 7048 6965 6990 
1 10 6990 6999 6966 6886 6843 6820 6821 6740 6729 6655 
3 7 6976 6977 6884 6832 6753 6640 6495 
3 5 6990 6885 6789 6728 6640 
3 5 6999 6864 6769 6614 6473 
2 9 7331 7258 7197 7071 6926 6820 6691 6572 6473 
2 9 6570 6571 6597 6629 6538 6495 6624 6585 6614 
2 7 6473 6539 6529 6496 6474 6566 6655 
3 9 7574 7497 7434 7381 7299 7237 7130 7059 6990 
1 8 6655 6718 6641 6562 6520 6462 6386 6575 
4 8 5863 5958 6042 6180 6296 6373 6494 6570 
3 4 6494 6438 6437 6339 
3 6 6976 7047 6947 6901 6892 6877 
1 2 7331 7319 
3 7 10404 10490 10586 10635 10713 10805 10817 
3 7 10067 10066 10056 9989 9915 9784 9740 
1 5 9740 9862 9988 10055 10120 
3 5 10120 10089 10131 10225 10364 
3 7 10364 10419 10466 10478 10585 10660 10691 
3 6 10691 10719 10728 10659 10591 10612 
4 10 8804 8803 8736 8735 8612 8517 8556 8501 8536 8568 
4 8 8568 8493 8481 8567 8516 8480 8479 8546 
4 6 9944 10103 10179 10226 10308 10404 
4 6 8546 8582 8574 8663 8642 8621 
2 7 8479 8410 8359 8369 8256 8293 8224 
3 5 8568 8464 8395 8339 8224 
3 7 8224 8172 8121 8013 7864 7711 7612 
4 9 8225 8150 8107 8035 8000 7891 7824 7681 7612 
4 5 8804 8936 9084 9227 9278 
4 10 9278 9310 9356 9525 9638 9648 9514 9628 9647 9637 
3 5 9740 9764 9649 9658 9638 
3 9 9278 9164 9182 9207 9083 8954 8802 8688 8568 
4 5 9278 9415 9563 9650 9740 
3 7 7574 7565 7619 7573 7599 7598 7612 
3 11 8621 8774 8907 9025 9076 9159 9251 9308 9342 9487 9614 
3 7 9637 9520 9445 9545 9425 9381 9355 
3 8 9355 9380 9488 9562 9451 9561 9572 9614 
3 8 9614 9645 9703 9729 9600 9543 9512 9414 
2 6 9637 9747 9820 9961 9962 10120 
3 4 9637 9681 9722 9793 
2 4 8574 8733 8852 8907 
2 5 8621 8566 8471 8390 8265 
2 8 8546 8478 8378 8304 8328 8292 8266 8265 
1 11 8546 8611 8622 8723 8839 8885 8990 9117 9180 9274 9355 
2 5 9355 9252 9264 9273 9251 
1 7 7236 7216 7141 7026 6986 6987 6958 
3 7 9793 9860 9969 10035 10021 10082 10112 
2 10 9355 9475 9601 9666 9746 9872 9913 9977 10042 10112 
2 7 10112 10064 9960 9875 9809 9705 9614 
2 6 10112 10239 10348 10418 10521 10612 
2 9 10404 10435 10434 10425 10444 10443 10365 10240 10120 
2 8 10817 10712 10661 10674 10673 10696 10695 10660 
1 7 10817 10793 10854 10870 10872 10883 10913 
3 5 10612 10736 10786 10887 10924 
1 6 10924 10973 10946 10982 10951 10972 
1 4 10913 10956 10955 10973 
3 8 10924 10899 10886 10804 10706 10727 10774 10752 
3 10 10612 10562 10575 10590 10647 10579 10561 10560 10536 10568 
1 17 9944 10084 10090 10263 10350 10504 10587 10637 10652 10682 10597 10436 10340 10241 10104 9938 9811 
