5 8 9394 9343 9280 9065 9142 9087 8946 8841 
5 5 9343 9279 9086 8965 8805 
5 5 9394 9370 9383 9243 9085 
5 6 9394 9466 9477 9426 9416 9395 
5 5 9085 9054 8886 8792 8804 
5 4 8841 8762 8690 8645 
5 7 9280 9293 9477 9549 9370 9279 9280 
4 7 8645 8585 8518 8519 8652 8781 8854 
4 13 8854 8794 8842 8822 8876 8896 8813 8753 8782 8830 8713 8626 8691 
3 7 8692 8755 8715 8627 8593 8550 8579 
2 15 8579 8551 8497 8454 8414 8475 8415 8498 8476 8182 8036 7897 7849 7656 7505 
2 11 7505 7310 7061 6880 6747 6968 6951 6866 6556 6308 5917 
1 6 7505 7604 7623 7635 7624 7438 
5 13 9085 9001 8910 8805 8737 8679 8701 8821 8841 8976 9104 9237 9395 
3 18 8691 8667 8603 8637 8638 8653 8571 8578 8654 8604 8588 8589 8590 8531 8591 8605 8655 8692 
5 2 9394 9549 
4 6 9549 9548 9652 9766 9916 10067 
1 4 9477 9615 9796 9944 
1 5 9395 9528 9684 9810 9944 
4 11 9395 9427 9573 9550 9707 9823 9802 9863 9842 9833 9811 
3 5 9944 9906 9971 10102 10067 
3 8 10067 9905 9775 9651 9526 9357 9208 9085 
3 6 9811 9723 9602 9468 9358 9212 
3 4 9212 9079 8956 8854 
1 12 9811 9797 9695 9531 9405 9281 9186 9088 9067 9056 8991 8830 
2 7 9823 9832 9831 9841 9887 9951 9944 
1 11 9395 9253 9230 9184 9210 9287 9344 9211 9128 9165 9212 
4 7 8841 8725 8569 8361 8247 8123 8084 
3 5 8645 8504 8340 8199 8084 
3 6 8519 8350 8236 8174 8069 8084 
3 6 7331 7206 7072 6941 6834 6655 
4 6 8084 7943 7826 7695 7567 7331 
5 5 8805 8689 8548 8428 8320 
4 5 8804 8634 8465 8398 8320 
4 9 8320 8257 8152 8173 8097 8026 7875 7835 7836 
2 5 8084 7981 7966 7942 7836 
3 6 7836 7694 7558 7559 7412 7331 
4 6 8804 8700 8537 8436 8267 8225 
4 12 8320 8151 8053 7954 7893 7751 7683 7574 7409 7287 7116 6976 
3 7 8320 8233 8133 8178 8226 8161 8225 
2 6 8178 8052 7980 7892 7782 7683 
1 9 8579 8693 8756 8832 9057 9170 9480 9591 9608 
1 9 9608 9804 9879 9954 10015 10213 10334 10481 10630 
1 8 7438 7570 7657 7689 7673 7715 7907 8158 
1 6 8158 8441 8833 9408 9409 9373 
4 6 6976 6870 6801 6738 6676 6570 
3 8 6976 7053 7054 7109 7117 7048 6965 6990 
1 10 6990 6999 6966 6886 6843 6820 6821 6740 6729 6655 
3 7 6976 6977 6884 6832 6753 6640 6495 
3 5 6990 6885 6789 6728 6640 
3 5 6999 6864 6769 6614 6473 
2 9 7331 7258 7197 7071 6926 6820 6691 6572 6473 
2 9 6570 6571 6597 6629 6538 6495 6624 6585 6614 
2 7 6473 6539 6529 6496 6474 6566 6655 
3 9 7574 7497 7434 7381 7299 7237 7130 7059 6990 
4 8 5863 5958 6042 6180 6296 6373 6494 6570 
2 4 6494 6438 6437 6339 
3 6 6976 7047 6947 6901 6892 6877 
1 2 7331 7319 
3 7 10404 10490 10586 10635 10713 10805 10817 
3 7 10067 10066 10056 9989 9915 9784 9740 
1 5 9740 9862 9988 10055 10120 
3 5 10120 10089 10131 10225 10364 
3 7 10364 10419 10466 10478 10585 10660 10691 
3 6 10691 10719 10728 10659 10591 10612 
4 10 8804 8803 8736 8735 8612 8517 8556 8501 8536 8568 
4 8 8568 8493 8481 8567 8516 8480 8479 8546 
4 6 9944 10103 10179 10226 10308 10404 
4 6 8546 8582 8574 8663 8642 8621 
2 7 8479 8410 8359 8369 8256 8293 8224 
3 5 8568 8464 8395 8339 8224 
3 7 8224 8172 8121 8013 7864 7711 7612 
4 9 8225 8150 8107 8035 8000 7891 7824 7681 7612 
4 5 8804 8936 9084 9227 9278 
4 10 9278 9310 9356 9525 9638 9648 9514 9628 9647 9637 
3 5 9740 9764 9649 9658 9638 
3 9 9278 9164 9182 9207 9083 8954 8802 8688 8568 
4 5 9278 9415 9563 9650 9740 
3 7 7574 7565 7619 7573 7599 7598 7612 
3 11 8621 8774 8907 9025 9076 9159 9251 9308 9342 9487 9614 
3 7 9637 9520 9445 9545 9425 9381 9355 
3 8 9355 9380 9488 9562 9451 9561 9572 9614 
3 8 9614 9645 9703 9729 9600 9543 9512 9414 
2 6 9637 9747 9820 9961 9962 10120 
3 4 9637 9681 9722 9793 
2 4 8574 8733 8852 8907 
2 5 8621 8566 8471 8390 8265 
2 8 8546 8478 8378 8304 8328 8292 8266 8265 
1 11 8546 8611 8622 8723 8839 8885 8990 9117 9180 9274 9355 
2 5 9355 9252 9264 9273 9251 
1 8 6958 6987 6986 7026 7141 7216 7236 7356 
3 7 9793 9860 9969 10035 10021 10082 10112 
2 10 9355 9475 9601 9666 9746 9872 9913 9977 10042 10112 
2 7 10112 10064 9960 9875 9809 9705 9614 
2 6 10112 10239 10348 10418 10521 10612 
2 9 10404 10435 10434 10425 10444 10443 10365 10240 10120 
2 8 10817 10712 10661 10674 10673 10696 10695 10660 
1 7 10817 10793 10854 10870 10872 10883 10913 
3 5 10612 10736 10786 10887 10924 
1 6 10924 10973 10946 10982 10951 10972 
1 4 10913 10956 10955 10973 
3 8 10924 10899 10886 10804 10706 10727 10774 10752 
3 10 10612 10562 10575 10590 10647 10579 10561 10560 10536 10568 
1 17 9944 10084 10090 10263 10350 10504 10587 10637 10652 10682 10597 10436 10340 10241 10104 9938 9811 
2 11 8691 8577 8422 8373 8262 8179 8078 7930 7805 7670 7423 
2 11 7423 7374 7347 7400 7288 7332 7322 7239 6930 6714 6485 
2 13 6485 6510 6598 6430 6151 6152 6168 6137 6169 6318 6345 6397 6450 
2 11 6450 6299 6067 5914 5970 6023 6139 6197 6210 6221 6231 
1 11 5914 6154 6284 6500 6658 6849 7019 7031 6967 7011 6960 
3 5 7011 7030 6980 7039 7181 
3 5 7019 7182 7158 7333 7375 
1 9 6960 6897 6845 6774 6563 6553 6465 6334 6152 
1 6 6960 6932 6810 6668 6541 6345 
1 8 5092 5147 4936 4710 4654 4537 4420 4305 
1 5 4305 4238 4090 4006 3898 
1 6 4936 5014 5161 5211 5259 5220 
1 7 5220 5352 5510 5746 5995 6097 6317 
1 4 7019 6792 6631 6450 
1 3 7030 7133 7289 
3 6 3843 3822 3877 3948 3941 4007 
3 4 4007 3963 4042 4028 
1 5 6345 6138 5894 5722 5566 
1 8 5334 5474 5657 5845 6050 6210 6346 6555 
1 5 6231 6301 6170 5984 5917 
1 3 6170 5977 5766 
1 5 5766 5584 5384 5196 4989 
3 11 4989 4825 4737 4678 4591 4554 4348 4297 4255 4149 4028 
2 5 4554 4726 4902 4913 4948 
1 6 4948 5105 5068 5205 5288 5334 
2 11 3898 3903 3833 3834 3813 3884 3841 3842 3828 3848 3843 
2 7 4577 4561 4578 4545 4562 4435 4405 
2 6 4405 4436 4590 4769 4947 4948 
1 11 3898 3966 4050 4041 4178 4185 4291 4375 4509 4570 4577 
1 10 4577 4528 4478 4365 4253 4179 4082 3991 3914 3843 
1 9 4561 4768 4840 4997 5194 5247 5354 5412 5566 
2 5 4007 4105 4172 4278 4405 
3 4 4007 3915 3815 3768 
3 5 3768 3717 3647 3592 3528 
3 7 3528 3397 3316 3265 3177 3090 3010 
2 4 3010 2924 2816 2728 
1 7 2728 2711 2659 2586 2460 2329 2213 
1 17 2213 2163 2102 2013 1894 1811 1729 1617 1510 1479 1385 1254 1182 1116 1060 980 888 
1 6 888 821 751 724 740 701 
1 4 3898 3861 3840 3783 
2 8 3843 3784 3790 3740 3710 3678 3640 3612 
2 7 3612 3568 3531 3476 3404 3315 3280 
1 5 3280 3302 3240 3295 3374 
1 6 3374 3350 3331 3349 3294 3380 
1 7 3380 3256 3164 3054 3030 2918 2799 
1 9 3380 3511 3555 3596 3527 3501 3426 3323 3141 
5 13 1898 2012 2075 2160 2244 2347 2471 2472 2306 2207 2133 2063 2075 
3 14 1775 1842 1933 2001 2095 2137 2191 2274 2348 2494 2578 2614 2648 2747 
4 2 2274 2245 
3 5 2747 2767 2820 2844 2897 
3 6 2747 2748 2852 2853 2919 2914 
1 3 287 308 241 
2 3 655 674 665 
1 13 3315 3324 3296 3272 3351 3287 3288 3289 3235 3136 3083 3068 3010 
1 4 878 877 850 841 
1 7 878 903 951 1010 1067 1146 1193 
3 7 1775 1807 1851 1857 1852 1789 1935 
1 6 3280 3224 3155 3072 2972 2914 
2 3 4948 5104 5260 
1 5 5260 5467 5583 5765 5914 
3 6 1775 1621 1501 1392 1260 1193 
3 3 7612 7651 7588 
4 3 7588 7557 7612 
4 5 7588 7650 7611 7631 7699 
2 13 7368 7479 7597 7609 7608 7735 7821 7855 7926 8024 8082 8142 8265 
3 4 6861 6842 6911 6877 
3 8 6861 6959 7016 7096 7219 7369 7514 7612 
4 6 6268 6306 6267 6321 6305 6310 
4 5 6268 6394 6483 6507 6611 
4 9 6611 6672 6817 6909 7014 7114 7107 7248 7368 
3 11 6861 6946 6940 6924 7036 7052 7087 7218 7249 7307 7368 
4 10 6268 6359 6427 6605 6621 6706 6772 6785 6786 6861 
2 4 6310 6426 6517 6611 
2 5 6861 6780 6674 6582 6583 
1 5 6583 6548 6448 6436 6352 
2 6 5824 5946 6019 6146 6174 6268 
3 6 5863 5864 5852 5825 5718 5663 
3 11 5663 5684 5608 5546 5541 5591 5564 5535 5429 5342 5239 
2 6 5718 5629 5590 5563 5398 5546 
2 5 4774 4881 4844 4787 4715 
3 8 5101 5177 5297 5374 5507 5554 5754 5863 
2 2 6110 6040 
1 8 6655 6718 6641 6562 6520 6615 6574 6575 
3 5 7699 7586 7457 7456 7368 
1 6 4774 4735 4649 11289 4473 4335 
2 2 5615 5648 
2 2 6447 6561 
2 3 7177 7245 7227 
5 12 4819 4748 4660 4541 4430 4329 4281 4274 4209 4141 4046 3965 
4 12 4329 4314 4260 4207 4233 4266 4308 4391 4475 4585 4659 4728 
4 4 4728 4683 4651 4799 
3 4 4651 4639 4746 4799 
4 6 4799 4847 4924 5006 5095 5109 
4 6 5109 5224 5395 5544 5649 5751 
4 6 4274 4275 4227 4215 4181 4251 
4 9 4251 4303 4383 4453 4523 4631 4729 4831 4906 
3 4 4906 5008 5061 5144 
3 8 5144 5238 5284 5397 5524 5617 5762 5850 
2 12 5649 5589 5553 5603 5616 5539 5522 5706 5796 5797 5787 5762 
2 9 5239 5146 5011 4884 4741 4646 4516 4404 4288 
2 5 4288 4246 4222 4286 4373 
2 9 4373 4515 4506 4652 4609 4587 4708 4719 4810 
2 7 5101 5075 4957 4868 4839 4821 4810 
3 10 3866 3970 4004 4095 4166 4252 4372 4505 4688 4810 
2 10 3866 3904 3946 4048 4183 4221 4268 4269 4283 4373 
2 11 6339 6352 6236 6159 6089 6073 5974 5924 5902 5965 5884 
3 6 4907 5021 5111 5226 5359 5493 
3 6 5493 5619 5730 5811 5823 5824 
2 6 5824 5763 5832 5840 5883 5884 
2 9 5824 5753 5626 5506 5464 5456 5448 5350 5274 
2 6 5274 5316 5257 5192 5193 5135 
2 6 5135 5159 5096 5183 5113 5177 
3 9 4907 4908 4894 4918 4765 4632 4602 4750 4751 
3 7 4751 4752 4866 4942 4967 4987 5135 
4 6 4907 4778 4644 4484 4355 4244 
4 4 3152 3204 3186 3252 
2 19 3152 3106 3088 3059 2986 2916 2842 2805 2686 2713 2714 2656 2647 2571 2555 2584 2635 2674 2628 
1 23 4288 4153 4154 4073 3971 3881 3809 3745 3666 3603 3379 3271 3196 3063 2963 2796 2700 2562 2409 2280 2159 2094 2031 
2 10 1984 2031 2093 2171 2183 2256 2320 2478 2577 2626 
2 12 2626 2664 2625 2601 2543 2542 2477 2465 2470 2443 2416 2326 
2 12 2326 2340 2362 2401 2361 2360 2354 2319 2294 2293 2289 2236 
2 6 2236 2272 2339 2368 2407 2492 
1 6 2326 2301 2219 2110 2071 1999 
2 7 2326 2304 2165 2099 2036 2018 1995 
2 11 2492 2539 2582 2611 2681 2737 2806 2893 2961 3053 3147 
2 11 2492 2467 2462 2489 2445 2475 2474 2484 2483 2498 2526 
2 6 2236 2198 2105 2070 1930 1725 
2 4 1725 1585 1446 1293 
5 3 4244 4152 4024 
1 8 1995 2008 1941 1855 1769 1671 1615 1616 
1 8 1999 1931 1818 1726 1611 1558 1439 1293 
4 8 4024 3919 3802 3729 3637 3651 3704 3719 
3 10 3919 3837 3749 3688 3649 3621 3565 3523 3505 3510 
5 9 3066 3134 3220 3205 3306 3377 3346 3411 3510 
4 6 3066 3119 3216 3328 3340 3418 
3 6 3418 3423 3424 3438 3455 3456 
3 5 3719 3653 3537 3550 3456 
3 5 3456 3393 3312 3227 3147 
3 8 3719 3779 3744 3781 3807 3826 3838 3866 
3 7 3066 3023 2943 2982 2917 2887 2828 
3 6 2828 2891 2980 2970 3007 2994 
2 7 2828 2753 2715 2684 2638 2567 2526 
2 8 2492 2590 2639 2661 2734 2826 2987 3066 
1 15 5239 5184 5064 5023 5012 4943 4898 4720 4553 4343 4176 4063 3981 3860 3793 
1 5 3793 3708 3655 3571 3501 
1 4 3719 3654 3631 3633 
4 2 522 590 
2 11 967 1031 1058 1064 1097 1144 1225 1224 1265 1329 1293 
4 5 967 966 900 891 844 
4 4 967 928 875 778 
3 9 967 1040 1094 1154 1230 1347 1435 1540 1616 
3 7 1616 1610 1489 1490 1461 1447 1530 
2 6 1530 1451 1404 1419 1448 1428 
1 7 1428 1541 1629 1718 1833 1927 1984 
1 7 1530 1612 1672 1755 1849 1926 1984 
3 3 778 754 745 
3 8 745 686 704 651 599 566 572 590 
2 10 967 945 990 939 892 946 993 940 994 985 
1 6 745 823 831 882 904 985 
1 6 985 1065 1159 1244 1328 1428 
2 8 590 652 734 783 801 865 876 985 
3 8 1664 1723 1827 1876 1891 1884 1972 1943 
2 7 1943 1895 1877 1821 1762 1763 1779 
1 10 5663 5777 5842 5927 6044 6165 6239 6353 6472 6473 
